WWWWWWWWWWWWWW
W-------W----W
W---P--------W
W-----*------W
W----------G-W
WWWW-WWWWWWWWW