WWWWWWWWWWW
W------P--W
W--*------W
W---------W
W---G-----W
WWWWWWWWWWW